1 21 5 1 3 7 7 5 5 3 7 3 5 3
2 3 3 1 7 5 7 5 3 3 5 7 7 5
3 35 7 1 3 3 5 7 5 7 3 5 3 7
4 15 5 1 7 7 7 3 5 3 7 3 5 7
5 35 7 1 7 5 5 3 3 7 3 5 5 3 5 7 3 5 3 3 5 7
6 21 3 1 5 3 7 5 3 7 5 7 7 5 3 5 3 7 3 7 5 3
7 3 5 1 3 21 3 7 5 3 7 5 3 5 21 3 7 21 7 5 3 5
8 35 5 1 5 7 15 35 7 3 5 7 3 5 35 3 7 15 7 5 35 7
9 15 15 1 35 3 7 5 21 7 3 21 3 15 5 35 7 5 21 3 21 15
10 7 15 1 3 5 7 21 5 21 3 35 3 15 21 3 7 35 7 5 21 15